**********************
*S    *     *  *     *
****  *  *  *  ***   *
*  *     *           *
*  *******  *******  *
*           *        *
****  ****  *  *  *  *
*     *        *  *  *
*  *  ****  *  *  *  *
*  *  *     *        *
* *****     ***  *****
*     **********  ****
*     *     *        *
****  *  *  *  *******
*  *     *        *  *
*  *******  *******  *
*           *        *
****  ****  *  *  *  *
*     *        *  *  *
*  *  ****  *  *  *  *
*  *  *     *       E*
**********************