****************
*S    *     *  *
****  *  *  *  *
*  *     *     *
*  **** **  ****
*              *
* ***********  *
* *            *
* ***********  *
*            E *
****************