****************
*S    *     *  *
****  *  *  *  *
*  *     *     *
*  *******  ****
*           *  *
****  *******  *
*              *
*   *********  *
*            E *
****************